111111111111111111111111111111
100000000000000000000000000001
108900000000000000000000008001
100900000000000000000000000001
100900000000000000000000000001
100900000000000000000000000001
100900000000000000000000000001
100999999990000000000000000001
100000000000000000000000000001
100111111110000000000000000001
100108000000000000000000000001
100100000000000000000000000001
100100000000000000000000000001
100000000100000000010000000001
100000000103040506010000000001
100000000111111111111000000001
100001000000000000000000000001
100001000000000000000001000001
100001111100000000000001000001
100000000100000000000001000001
100000000100000000000001000001
100000000100000000001111111001
100000000100000000000001000001
100000000100002000000001000101
100000080100000000000001000101
101111111100000111111111000101
101080000000000000000000080101
101111011111000111111111111101
108000000000000000000000000801
111111111111111111111111111111
