111111111111111111111111111111
111110000000000000000000011111
111110000000004000000000011111
111110000000000000000000011111
111111111111111111111111111111
100010000000000000000000010001
100010000000000000000000010001
100010007000000000000700010001
100010000000000000000000010001
100010000000000000000000010001
100010000070000000700000010001
100010000000000000000000010001
100010000000000000000000010001
100010000000000000000000010001
100010000000000000000000010001
106010000000002000000000010501
100010000000000000000000010001
100010000000000000000000010001
100010000070000000700000010001
100010000000000000000000010001
100010000000000000000000010001
100010007000000000000700010001
100010000000000000000000010001
100010000000000000000000010001
100010000000000000000000010001
111111111111111111111111111111
111110000000000000000000011111
111110000000003000000000011111
111110000000000000000000011111
111111111111111111111111111111
