111111111111111111111111111111
100000000000000000000000000001
100010000001111111000000000001
100010000001000000000000000001
100010000001000000050000000001
100010000001000500000000000001
100010050001000000000000000001
100010000000000000500000000001
100010000000000000000000050001
100011111100000000000000000001
100000000000050000000000000001
100000000000000000000000000001
100000000000000000100000000001
100010000000000000100000000001
100010000000000000100000000001
100010000000000500100000050001
100010000000000000100000000001
100010005000000000100000000001
100010000000001111100000000001
100010000000000000000000000001
100010005000000050000000000001
100011111111000000000000000001
100000000000000050000000050001
100000000000000000000000000001
100000000000000000000000000001
100000500000000000000000000001
100000000003222240000000000001
100000500000000000000000050001
100000000000000000000000000001
111111111111111111111111111111
